11111111111111111111111111111111111111111111111111
11CCCCCCCP111C111111C1111CCCCCCCC1111111CCC1111111
11C1111111111C111111C1111C1111111111111CC1CC111111
11C11111111111111111C1111C111111111111CC111CC11111
11C111CCCC111C111111C1111C111CCCC1111CCCCCCCCC1111
11C111111C111C111111C1111C111111C111CC1111111CC111
11C111111C111C111111C1111C111111C111C111111111CC11
11CCCCCCCCCCCCCCCCCCCCCCCCCCCCCCCCCCCCCCCCCCCCCCE1
11111111111111111111111111111111111111111111111111





