1111111111111111111111111111111111
11PC11CE1CCC11C1CC1CC1111111111C11
1CC111C1111C1C1C1C1C11C1C1CCCC1111
11CCC11C11C11CC11C1CC1CC1C11CCCC11
111CC11CC11C1CCCC1C1CC1C111C1CC111
1111111111111111111111111111111111
